1,1,1,1,1,1,1,1,1,1,1,1,1,1,1,1,
1,1,1,1,1,2,2,2,1,1,1,1,1,1,1,1,
1,1,1,1,1,2,2,2,1,2,2,1,1,1,1,1,
1,1,1,1,1,1,2,2,2,2,4,1,1,1,1,1,
1,1,1,1,1,1,2,1,1,1,4,1,1,1,1,1,
1,1,1,1,2,6,2,1,1,1,4,1,1,1,1,1,
1,1,1,1,2,6,6,1,1,1,1,1,1,1,1,1,
1,1,1,1,5,2,2,1,1,1,1,1,1,1,1,1,
1,1,1,1,1,1,1,1,1,1,1,1,1,1,1,1,
1,1,1,1,1,1,1,1,1,1,1,1,1,1,1,1