1,1,1,1,1,1,1,1,1,1,1,1,1,1,1,1,
1,2,5,1,2,2,2,2,2,2,2,2,2,2,2,1,
1,2,2,1,2,2,2,1,1,1,1,1,2,2,2,1,
1,6,6,6,2,2,2,1,2,2,2,2,2,2,2,1,
1,2,2,2,2,2,2,1,2,2,2,2,2,2,2,1,
1,3,3,3,1,1,1,1,2,2,2,2,2,2,4,1,
1,2,2,2,2,2,4,1,1,1,1,2,2,2,2,1,
1,2,2,2,2,2,2,2,2,2,2,2,2,1,1,1,
1,2,2,2,2,2,2,2,2,2,2,2,2,2,2,1,
1,1,1,1,1,1,1,1,1,1,1,1,1,1,1,1