1,1,1,0,0,1,1,1,1,1,1,1,0,1,1,1,
1,1,1,0,0,1,2,2,2,2,2,1,0,1,1,1,
1,1,1,0,0,1,2,6,2,5,2,1,0,1,1,1,
1,1,1,1,1,1,1,1,2,1,2,1,0,1,1,1,
1,1,1,1,2,6,2,2,2,2,2,1,0,1,1,1,
1,1,1,1,2,2,1,6,1,1,2,1,1,1,1,1,
1,1,1,1,4,4,6,2,2,1,2,2,1,1,1,1,
1,1,1,1,4,4,2,2,2,2,2,2,1,1,1,1,
1,1,1,1,1,1,1,1,1,1,1,1,1,1,1,1,
1,1,1,1,1,1,1,1,1,1,1,1,1,1,1,1