1,1,1,1,1,1,1,1,1,1,1,1,1,1,1,1,
1,1,1,1,1,1,1,1,1,1,1,1,1,1,1,1,
1,1,1,1,1,1,2,2,1,1,1,1,1,1,1,1,
1,1,1,1,1,1,2,2,2,2,2,1,1,1,1,1,
1,1,1,1,1,1,6,4,4,2,4,1,1,1,1,1,
1,1,1,1,1,2,2,1,1,5,1,1,1,1,1,1,
1,1,1,1,1,2,6,6,2,2,1,1,1,1,1,1,
1,1,1,1,1,2,2,2,2,2,1,1,1,1,1,1,
1,1,1,1,1,1,1,1,1,1,1,1,1,1,1,1,
1,1,1,1,1,1,1,1,1,1,1,1,1,1,1,1