1,1,1,1,1,1,1,1,1,1,1,1,1,1,1,1,
1,1,2,2,2,2,2,2,5,2,2,1,2,4,1,1,
1,1,2,2,2,2,2,2,1,2,2,1,2,4,1,1,
1,1,1,1,1,1,1,2,6,2,2,2,2,4,1,1,
1,1,2,2,1,2,2,1,6,2,2,1,2,2,1,1,
1,1,2,6,1,2,6,1,2,2,3,1,1,1,1,1,
1,1,2,2,2,2,2,6,2,3,2,2,2,1,1,1,
1,1,2,2,2,2,2,2,2,3,2,2,2,1,1,1,
1,1,2,2,2,2,2,2,2,1,2,2,4,1,1,1,
1,1,1,1,1,1,1,1,1,1,1,1,1,1,1,1